111111111111111111111111111111111111111111
100000000000000000001111111111001111111111
101100111001110011101111111111001111111111
1001000C1000C10000101111111111001111111111
10C1P0111001110011101111111111001111111111
100100001C0101000C101111111111001111111111
101110111001110011101111111111001111111111
100000000000000E00001111111111001111111111
111111111111111111101111111111001111111111
111111111111111111100000000000000000011111
111111111111111111111111111111111111111111
111111111111111111111111111111111111111111
111111111111111111111111111111111111111111
111111111111111111111111111111111111111111
111111111111111111111111111111111111111111
111111111111111111111111111111111111111111
111111111111111111111111111111111111111111