111111111111111111111
1P0000000000000000001
101100111001110011101
1001000C1000C10000101
10C100111001110000101
100100001C0001000C101
101110111001110000101
100000000000000000001
111111111111111111111