11111111111111111111111111111111111
10000000000000000000100000000000001
10110011100111001110100100100111101
1001000C1000C1000010100100100000101
1001P011100111000010100111100111101
100100001C0001000C10100000100100001
10111011100111000010100000100111101
10000000000000000000E00000000000001
11111111111111111111111111111111111