11111111111111111111111111111111
10000000000000000000000000000001
10000000000000000000000000000001
10000000000000000000000000000001
1P000010101110100011101101100001
10000010101010100010001010100001
100C0011101110100011101000100001
10000010101010100010001000100001
10000010101010111011101000100001
10000000000000000000000C00000001
100000000C00000000C00000000E0001
10000000000000000000000000000001
11111111111111111111111111111111