111111111111111111111111111111111111111111
1C0000CCCC000000000C000000C111111100000111
1000101000000001C0011000010000000000001111
100010100100000100011C00010000000111000011
1P001E100000000CCC01000C000011C11CCCC11011
1C0000CCCC010000000C0000000111111100000111
1000101000000001C0011000010000000000001111
1C0000C1CC010100000C0000100110C11100000111
1000101000010011C0011000010000000000001011
1C00C00CCC0000C1000C00C0000111111100000111
1C00C00CCC0000C1000C00C0000111111100000111
1C00C00CCC0000C1000C00C0000111111100000111
1C00C00CCC0000C1000C00C0000111111100000111
1C00C00CCC0000C1000C00C0000111111100000111
1C00C00CCC0000C1000C00C0000111111100000111
1C00C00CCC0000C1000C00C0000111111100000111
1C00C00CCC0000C1000C00C0000111111100000111
1C00C00CCC0000C1000C00C0000111111100000111
1000101000110001C00110000100001C0000001111
111111111111111111111111111111111111111111
111111111111111111111111111111111111111111
111111111111111111111111111111111111111111
111111111111111111111111111111111111111111