1111111111111111111111111111111111
10E00000000000C00000C0000000000001
1C10010100100000101001000000010101
101C110010101010001001000000010101
11C000000C00C000000000000C00000CP1
1111111111111111111111111111111111