1111111111111111111111111111111111
1000000000000000000000000000000001
1P11101101101110110010000000000001
10010C101C101010101010000000010101
1001001000101110101010000000010101
101110100C101010100110000C00000C01
1111111111111111111111111111111111
1111111111111111111111111111111111