11111111111111111111
100000E0000000000011
10000P00000000000001
11111111111111111111