111111111111111111111
100000000000000000001
101100111001110011101
1001000C1000C10000101
1001P0111001110000101
100100001C0001000C101
101110111001110000101
1000000000000000000E1
111111111111111111111