111111111111111111111111111111111111
1000000000000000000000000000000C0001
101100111001110011100100100100111101
10P1000C1000C10000100100100100000101
100100111001110000100100111100111101
100100001C0001000C100100000100100001
101110111001110000100100000100111101
1000000000000000000000E0000000000001
111111111111111111111111111111111111