11111111111111111111111111111111111
11111111111111111111111111111111111
10000000000000000000000000000000001
10000000000000000000000000000000001
10000000000000000000000000000000001
1P000001010111010001110111011100001
10000001010101010001000101010100001
100C0001110111010001110100100100001
10000001010101010001000100000100001
10000001010101011101110100000100011
100000000000000000000000C0000000001
1000000000C00000000C0000000000E0001
10000000000000000000000000000000001
11111111111111111111111111111111111