111111111
100C00111
1P00000C1
100C1C0E1
111111111