11111111111111111111
100000E0000000000011
10000P00000000000C01
11111111111111111111